1111111111111
1G0100000C001
100C011111001
1P0000E000C01
1111111111111
